--E-------
-PPP------
----------
-----V----
-V---PP---
-P--------
----------
-------H--
---PPPPPP-
LLLLLLLLLL