----------
--E----E--
-PP----PP-
----E-----
---PPPP---
----------
--+-H-----
--PPPPPP--
----------
LLLLLLLLLL