----H-----
----PP----
----------
---T--T---
---PPPP---
----------
-S------S-
PPP----PPP
----------
LLLLLLLLLL