----H-----
---PPPP-V-
-PP----PP-
-T--S---V-
-P--PPPPP-
-PP---PPP-
----------
--PPPPP---
----------
LLLLLLLLLL