----------
----------
--E-------
----------
----------
----------
----------
----------
----------
LLLLLLLLLL